111111111111111111111111111111111111111111111111111111111111111
1000000000000000000000001000000000000000000000000000000000000e1
100000000000000000000000100000000000000000000000000000000000001
100000000000000000000000100000000000000000000000000000000000001
100000000000000000000000100000000000000000000000000000000000001
100000000000000000000000100000000000000000000000000000000000001
100000000000000000000000100000000000000000000000000000000000001
100000000000000000000000100000000000000000000000000000000000001
100000000000000000000000100000000000000000000000000000000000001
100000000000000000000000100000000000000000000000000000000000001
100000000000000000000000100000000000000000000000000000000000001
100000000000000000000000100000000000000000000000000000000000001
100000000000000000000000100000000000000000000000000000000000001
100000000000000000000000100000000000000000000000000000000000001
100000000000000000000000100000000000000000000000000000000000001
100000000000000000000000100000000000000000000000000000000000001
100000000000000000000000100000000000000000000000000000000000001
100000000000000000000000100000000000000000000000000000000000001
100000000000000000000000100000000000000000000000000000000000001
100000000000000000000000100000000000000000000000000000000000001
100000000000000000000000100000000000000000000000000000000000001
100000000000000000000000100000000000000000000000000000000000001
100000000000000000000000100000000000000000000000000000000000001
100000000000000000000000100000000000000000000000000000000000001
100000000000000000000000100000000000000000000000000000000000001
100000000000000000000000100000000000000000000000000000000000001
100000000000000000000000100000000000000000000000000000000000001
100000000000000000000000100000000000000000000000000000000000001
100000000000000000000000100000000000000000000000000000000000001
100000000000000000000000100000000000000000000000000000000000001
100000000000000000000000100000000000000000000000000000000000001
100000000000000000000000100000000000000000000000000000000000001
100000000000000000000000100000000000000000000000000000000000001
100000000000000000000000100000000000000000000000000000000000001
100000000000000000000000100000000000000000000000000000000000001
100000000000000000000000100000000000000000000000000000000000001
100000000000000000000000100000000000000000000000000000000000001
100000000000000000000000100000000000000000000000000000000000001
100000000000000000000000100000000000000000000000000000000000001
100000000000000011111111100000000000000000000000000000000000001
100000000000000010000000000000000000000000000000000000000000001
100000000000000010000000000000000000000000000000000000000000001
100000000000000010000000000000000000000000000000000000000000001
100000000000000010000000000000000000000000000000000000000000001
100000000000000010000000000000000000000000000000000000000000001
100000000000000010000000000000000000000000000000000000000000001
100000000000000010000000000000000000000000000000000000000000001
100000000000000010000000000000000000000000000000000000000000001
100000000000000010000000000000000000000000000000000000000000001
100000000000000010000000000000000000000000000000000000000000001
100000000000000010000000000000000000000000000000000000000000001
100000000000000010000000000000000000000000000000000000000000001
100000000000000010000000000000000000000000000000000000000000001
100000000000000010000000000000000000000000000000000000000000001
100000000000000010000000000000000000000000000000000000000000001
100000000000000010000000000000000000000000000000000000000000001
100000000000000010000000000000000000000000000000000000000000001
100000000000000010000000000000000000000000000000000000000000001
100000000000000010000000000000000000000000000000000000000000001
100000000000000010000000000000000000000000000000000000000000001
100000000000000010000000000000000000000000000000000000000000001
100000000000000010000000000000000000000000000000000000000000001
1e00000000000000000000000000000000000000000000000000000000000e1
111111111111111111111111111111111111111111111111111111111111111